211111111111111111111111111112
100000000000000000000000000001
100000000000000000000000000001
100000000000000000000000000001
100000000000000000000000000001
100001000000000000000000100001
100000100000000000000001000001
100000010000000000000010000001
100000001000000000000100000001
100000000100000000001000000001
100000000010000000010000000001
100000000001000000100000000001
100000000000100001000000000001
100000000000000000000000000001
100000000000000000000000000001
100000000000000000000000000001
100000000000000000000000000001
100000000000100001000000000001
100000000001000000100000000001
100000000010000000010000000001
100000000100000000001000000001
100000001000000000000100000001
100000010000000000000010000001
100000100000000000000001000001
100001000000000000000000100001
100000000000000000000000000001
100000000000000000000000000001
100000000000000000000000000001
100000000000000000000000000001
211111111111111111111111111112
